{
    "start_sun": 8000,
    "lanes": [1,2,3,4,5],
    "scene": "lawn_day",
    "sun_fall": 1,
    "shroom_sleep": 1,
    "opening_grave": 0,
    "grave_danger": 0,
    "max_grave": 0,
    "wave_duration": [100, 450,100],
    "level": ["1-15","1-15"],
    "gimicks": ["last_stand"],
    "grave_area": [5,10],
    "sun_fall_duration": [300,600],
"zombie_spawn": [
    [1, 1, 1, 8, 8],
    [12, 12, 9, 9, 1],
    [13, 8, 8, 12, 12],
    [5, 9, 9, 1, 1],
    [3, 13, 8, 8, 12],
    [5, 3, 1, 1, 8, 8],
    [13, 9, 9, 12, 12, 1],
    [5, 3, 13, 8, 8, 12],
    [9, 9, 5, 3, 1, 1, 8],
    [13, 13, 8, 8, 12, 12, 1],
    [5, 3, 9, 9, 1, 1, 8, 8],
    [13, 8, 8, 12, 12, 1, 1, 9],
    [5, 3, 13, 9, 9, 12, 12],
    [8, 8, 12, 12, 1, 1, 9, 9],
    [13, 5, 3, 9, 9, 8, 8, 12],
    [8, 8, 12, 12, 1, 1, 9, 9, 13],
    [13, 5, 3, 9, 9, 8, 8, 12, 12],
    [8, 8, 12, 12, 1, 1, 9, 9, 13, 13],
    [13, 5, 3, 9, 9, 8, 8, 12, 12, 1],
    [8, 8, 12, 12, 1, 1, 9, 9, 13, 13, 5],
    [13, 5, 3, 9, 9, 8, 8, 12, 12, 1, 1],
    [8, 8, 12, 12, 1, 1, 9, 9, 13, 13, 5, 3],
    [13, 5, 3, 9, 9, 8, 8, 12, 12, 1, 1, 13],
    [8, 8, 12, 12, 1, 1, 9, 9, 13, 13, 5, 3, 8],
    [13, 5, 3, 9, 9, 8, 8, 12, 12, 1, 1, 13, 12],
    [8, 8, 12, 12, 1, 1, 9, 9, 13, 13, 5, 3, 8, 9],
    [13, 5, 3, 9, 9, 8, 8, 12, 12, 1, 1, 13, 12, 5],
    [8, 8, 12, 12, 1, 1, 9, 9, 13, 13, 5, 3, 8, 9, 3],
    [13, 5, 3, 9, 9, 8, 8, 12, 12, 1, 1, 13, 12, 5, 8],
    [8, 8, 12, 12, 1, 1, 9, 9, 13, 13, 5, 3, 8, 9, 3, 12, 1, 9, 13, 5]
],
    "big_wave": 10,
    "unlocks": ["void_1-16","False",5],
"end_dialogue":"27"
}